5 5
1 2 2 2 7
3 4 4 4 8
3 4 4 4 8
3 4 4 4 8
5 6 6 6 9