5 5
1 2 2 2 1
3 4 4 4 3
3 4 4 4 3
3 4 4 4 3
5 6 6 6 5